#################
#<____#___#____<#
#_###___#___###_#
#__#########____#
##_#_____#_#_####
#__#_#_#_#_#____#
#___#__#___#_##_#
###_#_#_##__#___#
#<__#__#@#__#_#<#
#__#_#_#_#_#__###
##_##__#_#_#_##<#
#__#__#__#_#____#
##_#_#__#__####_#
#__#__#__#__#___#
#_#_#_##_#___#__#
#<____<#_____#_<#
#################