#################
#<_____________<#
#__#__________#_#
#__##___________#
#____________##_#
#__________##___#
#_______________#
#_#_____________#
#<#_____@_____#<#
#__#__________#_#
#____________##<#
#_______________#
#__________###__#
#___________#___#
#___#_##________#
#<____<________<#
#################