#################
#<_____________<#
#_##__________###
#__#_______#____#
#_______________#
#_______________#
#_______________#
#_#_____________#
#<#_____@_____#<#
#__#__________#_#
#_____________#<#
#_______________#
#_______________#
#_##________#___#
#_##__##______###
#<____<________<#
#################