################
#______##______#
#______________#
#______##______#
#______#####_###
######_#####_###
######_#####__##
######_######_##
#______________#
#______________#
#______________#
#______________#
####_#########_#
####_#########_#
#______________#
################